15 15
###############
## #### #######
####### #######
####### #######
####### #######
######  #######
###### ########
###### ########
###### ########
###### ########
###### ########
###### 1  #####
######2     ###
#######      ##
###############

- 13 cases libre à droite
- 12 cases libre en haut
Il faut donc aller à droite