16 16
################
#              #
#              #
#  #  #  #  #  #
#              #
#              #
#  #  #  #  #  #
#              #
#              #
#  #  #  #  #  #
#              #
#              #
#  #  #  #  #  #
#              #
#              #
################
