8 8
########
#   #  #
#2  #  #
##  ##1#
##     #
##     #
##     #
########
