15 15
###############
####         2#
#  ########  ##
#         #1 ##
#            ##
#            ##
#            ##
#            ##
#            ##
#            ##
#            ##
#            ##
#            ##
#            ##
###############
