15 16
###############
###############
#### ##########
####1      ####
##### ###   ###
##   ## ##  # #
##   #   #  # #
##   #   #  # #
##   ## ##  # #
##    ###   # #
##          # #
##          # #
###2   #### # #
######## ## # #
######## #### #
###############

Mon Bot a un petit trouble de la personalité...
