15 14
###############
# 1 ###########
# #########  ##
#  ########  ##
#  ########  ##
#  ############
#   ## ###### #
#   ## ###### #
#   ########  #
#  2########  #
#  #########  #
#  #########  #
#  #########  #
###############

LOLz mon bot se fait seppuku^^


###############
# 1 ###########
# #########  ##
#  ########  ##
#  ########  ##
#  ############
#   ## ###### #
#   ## ###### #
#   ########  #
#  2########  #
#  #########  #
#  #########  #
#  #########  #
###############
